000000000000000-
111111011111122-
222222012222121-
123112311132121-
121222212222221-
322231113112311-
121222212222222-
121211011211111-
221211012222222-
000000000000000
